####################
#S  #             ##
### ### ############
# #   #           ##
# ### ########### ##
#     #           ##
# ##### ######### ##
#       #         ##
##################F#
####################